%%%%%%
%   .%
% %% %
% %%.%
%.P  %
% %%%%
%   .%
%%%%%%